##########
#  #######
##       #
## ##### #
## #   # #
## # ### #
## # ##  #
#  # ### #
##o     x#
##########